23 176
1 2 3 4 5 6 1 2 1 2 3 4 5 6 1 2 1 2 3 4 7 8 1 2 1 2 3 4 5 6 1 2 9 10 3 4 5 6 9 10 1 2 33 1 2 33 1 2 3 4 5 6 11 11 3 4 12 13 1 2 1 2 9 10 3 4 9 10 3 4 9 10 3 4 9 10 3 4 1 2 9 10 1 2 12 13 12 13 1 2 11 11 3 4 14 15 15 16 16 16 16 16 3 4 16 16 16 16 16 16 16 16 17 18 16 16 17 18 16 16 16 16 16 16 16 16 15 15 1 2 1 2 3 4 12 13 1 2 3 4 9 10 1 2 3 4 5 6 61 20 21 22 1 2 23 2 3 4 21 22 1 2 23 2 3 4 21 22 1 2 7 8 9 10 14 15 
9 10 3 4 28 29 30 31 32 33 3 4 28 29 30 31 32 33 3 4 7 8 30 31 32 33 3 4 28 29 30 31 26 27 3 4 28 29 11 11 32 33 32 33 32 33 32 33 3 4 35 36 11 11 3 4 32 33 32 33 32 33 26 27 3 4 11 11 3 4 11 11 3 4 11 11 3 4 32 33 11 11 32 33 32 33 32 33 32 33 11 11 3 4 16 38 38 16 16 39 16 16 3 18 16 16 40 16 40 16 40 16 3 18 16 39 3 4 16 16 16 16 40 16 40 16 16 38 32 33 26 27 3 4 32 33 32 33 3 4 11 11 32 33 3 4 28 29 26 27 32 33 41 42 43 44 3 4 45 46 41 42 43 44 3 4 45 46 41 42 7 8 11 11 47 15 
12 13 3 4 48 49 9 10 1 2 3 4 48 49 9 10 1 2 3 4 5 6 9 10 1 2 3 4 48 49 9 10 12 13 3 4 48 49 11 11 1 2 1 2 1 2 1 2 3 4 50 1 11 11 3 4 1 2 1 2 1 2 12 13 3 4 11 11 3 4 11 11 3 4 11 11 3 4 1 2 11 11 1 2 1 2 1 2 1 2 11 11 3 4 16 38 38 16 16 53 16 16 17 18 16 16 16 16 16 16 16 16 17 18 16 53 3 4 16 16 16 16 16 16 16 16 16 38 1 2 12 13 3 4 1 2 1 2 3 4 11 11 1 2 3 4 48 49 12 13 1 2 3 4 23 2 3 4 21 22 3 4 23 2 3 4 21 22 3 4 5 6 11 11 14 15 
32 33 3 4 35 36 11 11 32 33 3 4 28 29 11 11 32 33 3 4 28 29 11 11 32 33 3 4 28 29 11 11 32 33 3 4 28 29 11 11 32 33 32 33 54 55 56 57 58 59 60 61 62 62 62 62 63 64 32 33 32 33 32 33 3 4 11 11 3 4 11 11 3 4 11 11 3 4 30 31 11 11 32 33 54 55 56 57 62 62 60 61 58 59 16 38 38 16 16 16 16 16 58 59 16 16 16 16 67 68 67 68 3 4 67 68 3 4 16 16 16 39 16 16 16 16 16 38 32 33 62 62 62 62 63 64 32 33 3 4 11 11 32 33 3 4 35 36 32 33 32 33 3 4 2 2 3 4 2 2 3 4 2 2 3 4 2 2 3 4 35 61 11 11 16 38 
1 2 3 4 50 1 11 11 1 2 3 4 48 49 11 11 1 2 3 4 48 49 11 11 1 2 3 4 48 49 11 11 1 2 3 4 48 49 11 11 1 2 1 2 70 56 71 15 15 15 15 15 15 15 15 15 15 72 73 61 1 2 1 2 3 4 11 11 3 4 11 11 3 4 11 11 3 4 9 10 11 11 1 2 70 56 71 15 15 15 15 15 15 15 15 15 15 15 15 15 15 15 15 15 16 16 16 16 38 75 38 75 3 4 38 75 3 4 16 16 16 53 15 15 15 15 15 15 15 15 15 15 15 15 15 72 64 33 3 4 11 11 1 2 3 4 50 1 32 33 1 2 3 4 1 2 3 4 1 2 3 4 1 2 3 4 1 2 3 4 50 61 11 11 16 38 
32 33 3 4 32 33 11 11 32 33 3 4 35 36 11 11 30 31 3 4 28 29 11 11 32 33 3 4 35 36 11 11 32 33 3 4 28 29 11 11 54 55 56 57 77 71 78 79 3 4 32 33 26 27 3 4 32 81 72 82 60 61 62 62 3 4 11 11 3 4 11 11 3 4 11 11 3 4 26 27 11 11 54 55 56 71 78 79 32 33 32 33 41 42 47 15 15 16 67 68 67 68 3 4 16 16 62 91 16 16 67 68 15 15 15 15 15 15 16 16 62 91 16 16 16 39 3 18 7 8 32 33 41 42 32 81 72 82 62 62 32 33 62 62 62 62 63 64 1 32 33 33 3 4 32 33 3 4 2 2 3 4 32 33 3 4 32 33 3 4 61 61 56 57 16 38 
1 2 3 4 1 2 11 11 1 2 3 4 50 1 11 11 9 10 3 4 48 49 11 11 1 2 3 4 50 1 11 11 1 2 3 4 48 49 11 11 70 56 71 15 15 15 87 88 3 4 1 2 12 13 3 4 19 20 15 15 15 15 15 15 3 4 11 11 3 4 11 11 3 4 11 11 3 4 12 13 11 11 70 56 71 89 87 88 1 2 1 2 3 4 14 15 15 16 38 75 38 75 3 4 15 15 15 72 91 75 38 75 15 15 15 15 41 42 15 15 15 72 91 16 16 53 3 18 5 6 1 2 3 4 32 20 15 15 15 15 15 15 15 15 15 15 15 72 64 1 2 33 3 4 1 2 3 4 1 2 3 4 1 2 3 4 1 2 3 4 70 56 71 15 15 15 
32 33 3 4 32 33 11 11 30 31 3 4 32 33 11 11 26 27 3 4 35 36 11 11 32 33 3 4 32 33 11 11 30 31 3 4 35 36 54 55 56 71 78 79 30 31 32 33 3 4 32 33 32 33 3 4 32 33 3 4 30 31 30 31 3 4 11 11 3 4 11 11 3 4 11 11 3 4 30 31 54 55 56 71 78 79 30 31 32 33 32 33 3 4 47 15 15 16 16 16 16 16 3 4 67 68 3 4 72 91 16 16 15 15 15 15 3 4 67 68 3 4 72 91 16 16 3 18 35 36 32 33 3 4 32 33 30 31 3 4 26 27 3 4 26 27 61 81 72 64 1 32 3 4 32 33 3 4 2 2 3 4 32 33 3 4 32 33 3 4 77 71 78 88 47 15 
1 2 3 4 1 2 11 11 9 10 3 4 1 2 11 11 12 13 3 4 50 1 11 11 1 2 3 4 1 2 11 11 9 10 3 4 50 1 70 56 71 89 87 88 9 10 1 2 3 4 1 2 1 2 3 4 1 2 3 4 9 10 9 10 3 4 11 11 3 4 11 11 3 4 11 11 3 4 9 10 70 56 71 89 87 88 9 10 1 2 1 2 3 4 14 15 15 16 16 16 16 16 17 18 38 75 3 4 93 72 91 16 15 15 15 15 17 18 38 75 3 4 93 72 91 16 3 18 50 1 1 2 3 4 1 2 9 10 3 4 12 13 3 4 12 13 61 20 94 72 64 1 3 4 1 2 3 4 1 2 3 4 1 2 3 4 1 2 3 4 15 15 87 88 14 15 
60 61 58 59 60 61 60 61 60 61 58 59 60 61 60 61 60 61 58 59 60 61 60 61 60 61 58 59 60 61 60 61 60 61 58 59 60 61 77 71 60 61 60 61 60 61 60 61 58 59 60 61 60 61 58 59 60 61 58 59 60 61 60 61 58 59 60 61 58 59 60 61 58 59 60 61 58 59 60 61 77 71 60 61 60 61 60 61 60 61 60 61 58 59 95 15 15 16 62 91 16 16 58 59 16 16 58 59 16 93 72 97 15 15 15 15 58 59 62 91 58 59 16 93 72 97 3 18 60 61 60 61 58 59 60 61 60 61 58 59 60 61 58 59 60 61 60 61 60 61 72 82 58 59 60 61 58 59 60 61 58 59 60 61 58 59 60 61 58 59 60 61 60 61 95 15 
15 15 15 15 15 15 15 15 15 15 15 15 15 15 15 15 15 15 15 15 15 15 15 15 15 15 15 15 15 15 15 15 15 15 15 15 15 15 15 15 15 15 15 15 15 15 15 15 15 15 15 15 15 15 15 15 15 15 15 15 15 15 15 15 15 15 15 15 15 15 15 15 15 15 15 15 15 15 15 15 15 15 15 15 15 15 15 15 15 15 15 15 15 15 15 15 15 15 15 72 15 15 15 15 15 15 15 15 15 15 15 15 15 15 15 15 15 15 15 72 15 15 15 15 15 15 15 15 15 15 15 15 15 15 15 15 15 15 15 15 15 15 15 15 15 15 15 15 15 15 15 15 15 15 15 15 15 15 15 15 15 15 15 15 15 15 15 15 15 15 15 15 15 15 15 15 
38 38 38 38 38 38 38 38 38 38 38 38 38 38 38 38 38 38 38 38 38 38 38 38 38 38 38 38 38 38 38 38 38 38 38 38 38 38 38 38 38 38 38 38 38 38 38 38 38 38 38 38 38 38 38 38 38 38 38 38 38 38 38 38 38 38 38 38 38 38 38 38 38 38 38 38 38 38 38 38 38 38 38 38 38 38 38 38 38 38 38 38 38 38 38 38 38 38 38 38 38 38 38 38 38 38 38 38 38 38 38 38 38 38 38 38 38 38 38 38 38 38 38 38 38 38 38 38 38 38 38 38 38 38 38 38 38 38 38 38 38 38 38 38 38 38 38 38 38 38 38 38 38 38 38 38 38 38 38 38 38 38 38 38 38 38 38 38 38 38 38 38 38 38 38 38 
38 38 38 38 38 38 38 38 38 38 38 38 38 38 38 38 38 38 38 38 38 38 38 38 38 38 38 38 38 38 38 38 38 38 38 38 38 38 38 38 38 38 38 38 38 38 38 38 38 38 38 38 38 38 38 38 38 38 38 38 38 38 38 38 38 38 38 38 38 38 38 38 38 38 38 38 38 38 38 38 38 38 38 38 38 38 38 38 38 38 38 38 38 38 38 38 41 42 16 72 100 38 41 42 38 38 38 38 41 42 38 38 41 42 38 38 3 4 16 72 100 38 38 38 41 42 3 18 38 38 38 38 38 38 38 38 38 38 38 38 38 38 38 38 38 38 38 38 38 38 38 38 38 38 38 38 38 38 38 38 38 38 38 38 38 38 38 38 38 38 38 38 38 38 38 38 
38 38 38 38 38 38 38 38 38 38 38 38 38 38 38 38 38 38 38 38 38 38 38 38 38 38 38 38 38 38 38 38 38 38 38 38 38 38 38 38 38 38 38 38 38 38 38 38 38 38 38 38 38 38 38 38 38 38 38 38 38 38 38 38 38 38 38 38 38 38 38 38 38 38 38 38 38 38 38 38 38 38 38 38 38 38 38 38 38 38 38 38 38 38 38 38 3 4 16 16 72 100 3 18 38 38 38 38 3 18 38 38 3 4 38 38 3 4 16 16 72 100 38 38 3 4 3 18 38 38 38 38 38 38 38 38 38 38 38 38 38 38 38 38 38 38 38 38 38 38 38 38 38 38 38 38 38 38 38 38 38 38 38 38 38 38 38 38 38 38 38 38 38 38 38 38 
38 38 38 38 38 38 38 38 38 38 38 38 38 38 38 38 38 38 38 38 38 38 38 38 38 38 38 38 38 38 38 38 38 38 38 38 38 38 38 38 38 38 38 38 38 38 38 38 38 38 38 38 38 38 38 38 38 38 38 38 38 38 38 38 38 38 38 38 38 38 38 38 38 38 38 38 38 38 38 38 38 38 38 38 38 38 38 38 38 38 38 38 38 38 38 38 3 4 16 16 16 72 17 18 38 38 38 38 17 18 38 38 3 4 38 38 3 4 16 16 16 72 100 38 3 4 3 18 38 38 38 38 38 38 38 38 38 38 38 38 38 38 38 38 38 38 38 38 38 38 38 38 38 38 38 38 38 38 38 38 38 38 38 38 38 38 38 38 38 38 38 38 38 38 38 38 
38 38 38 38 38 38 38 38 38 38 38 38 38 38 38 38 38 38 38 38 38 38 38 38 38 38 38 38 38 38 38 38 38 38 38 38 38 38 38 38 38 38 38 38 38 38 38 38 38 38 38 38 38 38 38 38 38 38 38 38 38 38 38 38 38 38 38 38 38 38 38 38 38 38 38 38 38 38 38 38 38 38 38 38 38 38 38 38 38 38 38 38 38 38 38 38 3 18 16 16 16 16 15 15 38 38 38 38 3 18 38 38 3 4 38 38 3 4 16 16 16 16 72 100 3 4 3 18 38 38 38 38 38 38 38 38 38 38 38 38 38 38 38 38 38 38 38 38 38 38 38 38 38 38 38 38 38 38 38 38 38 38 38 38 38 38 38 38 38 38 38 38 38 38 38 38 
38 38 38 38 38 38 38 38 38 38 38 38 38 38 38 38 38 38 38 38 38 38 38 38 38 38 38 38 38 38 38 38 38 38 38 38 38 38 38 38 38 38 38 38 38 38 38 38 38 38 38 38 38 38 38 38 38 38 38 38 38 38 38 38 38 38 38 38 38 38 38 38 38 38 38 38 38 38 38 38 38 38 38 38 38 38 38 38 38 38 38 38 38 38 38 38 17 18 16 16 16 16 41 42 38 38 38 38 17 18 38 38 3 4 38 38 3 4 16 16 16 16 16 72 3 4 3 18 38 38 38 38 38 38 38 38 38 38 38 38 38 38 38 38 38 38 38 38 38 38 38 38 38 38 38 38 38 38 38 38 38 38 38 38 38 38 38 38 38 38 38 38 38 38 38 38 
38 38 38 38 38 38 38 38 38 38 38 38 38 38 38 38 38 38 38 38 38 38 38 38 38 38 38 38 38 38 38 38 38 38 38 38 38 38 38 38 38 38 38 38 38 38 38 38 38 38 38 38 38 38 38 38 38 38 38 38 38 38 38 38 38 38 38 38 38 38 38 38 38 38 38 38 38 38 38 38 38 38 38 38 38 38 38 38 38 38 38 38 38 38 38 38 15 15 15 15 15 15 15 15 15 15 15 15 15 15 38 38 15 15 38 38 15 15 15 15 15 15 15 15 15 15 3 18 38 38 38 38 38 38 38 38 38 38 38 38 38 38 38 38 38 38 38 38 38 38 38 38 38 38 38 38 38 38 38 38 38 38 38 38 38 38 38 38 38 38 38 38 38 38 38 38 
38 38 38 38 38 38 38 38 38 38 38 38 38 38 38 38 38 38 38 38 38 38 38 38 38 38 38 38 38 38 38 38 38 38 38 38 38 38 38 38 38 38 38 38 38 38 38 38 38 38 38 38 38 38 38 38 38 38 38 38 38 38 38 38 38 38 38 38 38 38 38 38 38 38 38 38 38 38 38 38 38 38 38 38 38 38 38 38 38 38 38 38 38 38 38 38 41 42 101 102 101 102 41 42 103 104 101 102 41 42 38 38 41 42 38 38 41 42 101 102 101 102 101 102 3 4 3 18 38 38 38 38 38 38 38 38 38 38 38 38 38 38 38 38 38 38 38 38 38 38 38 38 38 38 38 38 38 38 38 38 38 38 38 38 38 38 38 38 38 38 38 38 38 38 38 38 
0 0 0 0 0 0 38 38 38 38 38 38 38 38 38 38 38 38 38 38 38 38 38 38 38 38 38 38 38 38 38 38 38 38 38 38 38 38 38 38 38 38 38 38 38 38 38 38 38 38 38 38 38 38 38 38 38 38 38 38 38 38 38 38 38 38 38 38 38 38 38 38 38 38 38 38 38 38 38 38 38 38 38 38 38 38 38 38 38 38 38 38 38 38 38 38 3 18 38 38 38 38 3 18 105 106 107 107 3 4 38 38 3 4 38 108 3 4 107 107 38 108 38 38 3 4 15 15 38 38 38 38 38 38 38 38 38 38 38 38 38 38 38 38 38 38 38 38 38 38 38 38 38 38 38 38 38 38 38 38 38 38 38 38 38 38 38 38 38 38 38 38 38 38 38 38 
38 38 38 38 38 38 38 38 38 38 38 38 38 38 38 38 38 38 38 38 38 38 38 38 38 38 38 38 38 38 38 38 38 38 38 38 38 38 38 38 38 38 38 38 38 38 38 38 38 38 38 38 38 38 38 38 38 38 38 38 38 38 38 38 38 38 38 38 38 38 38 38 38 38 38 38 38 38 38 38 38 38 38 38 38 38 38 38 38 38 38 38 38 38 38 38 17 18 38 38 38 38 17 18 38 38 107 107 3 4 109 110 3 4 109 110 3 4 107 107 109 110 38 38 3 4 101 102 38 38 38 38 38 38 38 38 38 38 38 38 38 38 38 38 38 38 38 38 38 38 38 38 38 38 38 38 38 38 38 38 38 38 38 38 38 38 38 38 38 38 38 38 38 38 38 38 
38 38 38 38 38 38 38 38 38 38 38 38 38 38 38 38 38 38 38 38 38 38 38 38 38 38 38 38 38 38 38 38 38 38 38 38 38 38 38 38 38 38 38 38 38 38 38 38 38 38 38 38 38 38 38 38 38 38 38 38 38 38 38 38 38 38 38 38 38 38 38 38 38 38 38 38 38 38 38 38 38 38 38 38 38 38 38 38 38 38 38 38 38 38 38 38 112 112 112 112 112 112 112 112 112 112 112 112 112 112 112 112 112 112 112 112 112 112 112 112 112 112 112 112 15 15 112 112 38 38 38 38 38 38 38 38 38 38 38 38 38 38 38 38 38 38 38 38 38 38 38 38 38 38 38 38 38 38 38 38 38 38 38 38 38 38 38 38 38 38 38 38 38 38 38 38 
38 38 38 38 38 38 38 38 38 38 38 38 38 38 38 38 38 38 38 38 38 38 38 38 38 38 38 38 38 38 38 38 38 38 38 38 38 38 38 38 38 38 38 38 38 38 38 38 38 38 38 38 38 38 38 38 38 38 38 38 38 38 38 38 38 38 38 38 38 38 38 38 38 38 38 38 38 38 38 38 38 38 38 38 38 38 38 38 38 38 38 38 38 38 38 38 113 114 113 114 113 114 113 114 113 114 113 114 113 114 113 114 113 114 113 114 113 114 113 114 113 114 113 114 41 42 113 114 38 38 38 38 38 38 38 38 38 38 38 38 38 38 38 38 38 38 38 38 38 38 38 38 38 38 38 38 38 38 38 38 38 38 38 38 38 38 38 38 38 38 38 38 38 38 38 38
